TTTTBBBBBBBBBBBBBBBBBBBBBBBBBBBBBBBTTTTTTTTTTTRRRRRRRRRRRRRRRRRRRRRRRRRRRRRRRRRR
TTTTBBBBBBBBBBBBBBBBBBBBBBBBBBBBBBBTTTTTTTTTTTRRRRRRRRRRRRRRRRRRRRRRRRRRRRRRRRRR
TTTTBBBBBBBBBBBBBBBBBBBBBBBBBBBBBBBTTTTTTTTTTTRRRRRRRRRRRRRRRRRRRRRRRRRRRRRRRRRR
TTBBBBBBBBBBBBBBBBBBBBBBBBBBBBBBBBBBBTTTTTTTTTRRRRRRRRRRRRRRRRRRRRRRRRRRRRRRRRRR
TTBBBBBBBBBBBBBBBBBBBBBBBBBBBBBBBBBBBTTTTTTTTTRRRRRRRRRRRRRRRRRRRRRRRRRRRRRRRRRR
TTBBBBBBBBBBBBBBBBBBBBBBBBBBBBBBBBBBBTTTTTTTTTTTTTTTTTTTTTRRRRRRRRRRRRRRRRRRRRRR
TTBBBBBBBBBBBBBBBBBBBBBBBBBBBBBBBBBBBTTTTTTTTTTTTTTTTTTTTTRRRRRRRRRRRRRRRRRRRRRR
TTBBBBBBBBBBBBBBBBBBBBBBBBBBBBBBBBBBBTTTTTTTTTTTTTTTTTTTTTRRRRRRRRRRRRRRRRRRRRRR
TTBBBBBBBBBBBBBBBBBBBBBBBBBBBBBBBBBBBTTTTTTTTTTTTTTTTTTTTTRRRRRRRRRRRRRRRRRRRRRR
TTBBBBBBBBBBBBBBBBBBBBBBBBBBBBBBBBBBBPPPPPPPPPPPPPPPPPPTTTRRRRRRRRRRRRRRRRRRRRRR
TTBBBBBBBBBBBBBBBBBBBBBBBBBBBBBBBBBBBPPPPPPPPPPPPPPPPPPTTTRRRRRRRRRRRRRRRRRRRRRR
TTBBBBBBBBBBBBBBBBBBBBBBBBBBBBBBBBBBBPPPPPPPPPPPPPPPPPPTTTRRRRRRRRRRRRRRRRRRRRRR
TTBBBBBBBBBBBBBBBBBBBBBBBBBBBBBBBBBBBPPPPPPPPPPPPPPPPPPTTTRRRRRRRRRRRRRRRRRRRRRR
TTBBBBBBBBBBBBBBBBBBBBBBBBBBBBBBBBBBBPPPPPPPPPPPPPPPPPPTTTRRRRRRRRRRRRRRRRRRRRRR
TTBBBBBBBBBBBBBBBBBBBBBBBBBBBBBBBBBBBPPPPPPPPPPPPPPPPPPTTTRRRRRRRRRRRRRRRRRRRRRR
TTBBBBBBBBBBBBBBBBBBBBBBBBBBBBBBBBBBBPPPPPPPPPPPPPPPPPPTTTRRRRRRRRRRRRRRRRRRRRRR
TTBBBBBBBBBBBBBBBBBBBBBBBBBBBBBBBBBBBPPPPPPPPPPPPPPPPPPTTTRRRRRRRRRRRRRRRRRRRRRR
TTBBBBBBBBBBBBBBBBBBBBBBBBBBBBBBBBBBBPPPPPPPPPPPPPPPPPPTTTRRRRRRRRRRRRRRRRRRRRRR
TTBBBBBBBBBBBBBBBBBBBBBBBBBBBBBBBBBBBPPPPPPPPPPPPPPPPPPTTTRRRRRRRRRRRRRRRRRRRRRR
TTBBBBBBBBBBBBBBBBBBBBBBBBBBBBBBBBBBBPPPPPPPPPPPPPPPPPPTTTRRRRRRRRRRRRRRRRRRRRRR
TTBBBBBBBBBBBBBBBBBBBBBBBBBBBBBBBBBBBPPPPPPPPPPPPPPPPPPTTTTTTTRRRRRRRRRRRRRRTTTT
TTBBBBBBBBBBBBBBBBBBBBBBBBBBBBBBBBBBBPPPPPPPPPPPPPPPPPPTTTTTTTRRRRRRRRRRRRRRTTTT
TTBBBBBBBBBBBBBBBBBBBBBBBBBBBBBBBBBBBPPPPPPPPPPPPPPPPPPTTTTTTTRRRRRRRRRRRRRRTTTT
TTBBBBBBBBBBBBBBBBBBBBBBBBBBBBBBBBBBBPPPPPPPPPPPPPPPPPPTTTTTTTRRRRRRRRRRRRRRTTTT
TTBBBBBBBBBBBSSSSSSSSSSSSSSSSSSSSSSSSPPPPPPPPPPPPPPPPPPTTTTTTTTTTTTTTTTTTTTTTTTT
TTBBBBBBBBBBBSSSSSSSSSSSSSSSSSSSSSSSSPPPPPPPPPPPPPPPPPPTTTTTTTTTTTTTTTTTTTTTTTTT
TTBBBBBBBBBBBSSSSSSSSSSSSSSSSSSSSSSSSPPPPPPPPPPPPPPPPPPTTTTTTTTTTTTTTTTTTTTTTTTT
TTBBBBBBBBBBBSSSSSSSSSSSSSSSSSSSSSSSSPPPPPPPPPPPPPPPPPPTTTTTTTTTTTTTTTTTTTTTTTTT
TTBBBBBBBBBBBSSSSSSSSSSSSSSSSSSSSSSSSPPPPPPPPPPPPPPPPPPTTTTTTTTTTTTTTTTTTTTTTTTT
TTBBBBBBBBBBBSSSSSSSSSSSSSSSSSSSSSSSSTTPPPPPPPPPPPPTTSSSSSSSSSSSSSSSSSSSSSSSSTTT
TTBBBBBBBBBBBSSSSSSSSSSSSSSSSSSSSSSSSTTPPPPPPPPPPPPTTSSSSSSSSSSSSSSSSSSSSSSSSTTT
TTBBBBBBBBBBBSSSSSSSSSSSSSSSSSSSSSSSSTTPPPPPPPPPPPPTTSSSSSSSSSSSSSSSSSSSSSSSSTTT
TTBBBBBBBBBBBSSSSSSSSSSSSSSSSSSSSSSSSTTPPPPPPPPPPPPTTSSSSSSSSSSSSSSSSSSSSSSSSTTT
TTBBBBBBBBBBBSSSSSSSSSSSSSSSSSSSSSSSSTTPPPPPPPPPPPPTTSSSSSSSSSSSSSSSSSSSSSSSSTTT
TTTTTTTTTTTSSSSSSSSSSSSSSSSSSSSSSSSSSTTPPPPPPPPPPPPTTSSSSSSSSSSSSSSSSSSSSSSSSTTT
TTTTTTTTTTTSSSSSSSSSSSSSSSSSSSSSSSSSSTTPPPPPPPPPPPPTTSSSSSSSSSSSSSSSSSSSSSSSSTTT
TTTTTTTTTTTSSSSSSSSSSSSSSSSSSSSSSSSSSTTTTTTTTTTTTTTTTSSSSSSSSSSSSSSSSSSSSSSSSTTT
TTTTTTTTTTTSSSSSSSSSSSSSSSSSSSSSSSSSSTTTTTTTTTTTTTTTTSSSSSSSSSSSSSSSSSSSSSSSSTTT
TTTTTTTTTTTSSSSSSSSSSSSSSSSSSSSSSSSSSTTTTTTTTTTTTTTTTSSSSSSSSSSSSSSSSSSSSSSSSTTT
TTTTTTTTTTTSSSSSSSSSSSSSSSSSSSSSSSSSSTTTTTTTTTTTTTTTTSSSSSSSSSSSSSSSSSSSSSSSSTTT
TTTTTTTTTTTSSSSSSSSSSSSSSSSSSSSSSSSSSTTTTTTTTTTTTTTTTSSSSSSSSSSSSSSSSSSSSSSSSTTT
TTTTTTTTTTTSSSSSSSSSSSSSSSSSSSSSSSSSSTTTTTTTTTTTTTTTTSSSSSSSSSSSSSSSSSSSSSSSSTTT
TTTTTTTTTTTSSSSSSSSSSSSSSSSSSSSSSSSSSTTTTTTTTTTTTTTTTSSSSSSSSSSSSSSSSSSSSSSSSTTT
TTTRRRRRRRRRRRRRRRRRRRRRRRRRTTTTTTTTTTTTTTTTTTTTTTTTTSSSSSSSSSSSSSSSSSSSSSSSSTTT
TTRRRRRRRRRRRRRRRRRRRRRRRRRRRRRRTTTTTTTTTTTTTTTTTTTTTSSSSSSSSSSSSSSSSSSSSSSSSTTT
TRRRRRRRRRRRRRRRRRRRRRRRRRRRRRRRTTTTTTTTTTTTTTTTTTTTTSSSSSSSSSSSSSSSSSSSSSSSSTTT
TRRRRRRRRRRRRRRRRRRRRRRRRRRRRRRRTTTTTTTTTTTTTTTTTTTTTSSSSSSSSSSSSSSSSSSSSSSSSTTT
TRRRRRRRRRRRRRRRRRRRRRRRRRRRRRRRTTTTTTTTTTTTTTTTTTTTTSSSSSSSSSSSSSSSSSSSSSSSSTTT
TRRRRRRRRRRRRRRRRRRRRRRRRRRRRRRRTTTTTTTTTTTTTTTTTTTTTSSSSSSSSSSSSSSSSSSSSSSSSTTT
TRRRRRRRRRRRRRRRRRRRRRRRRRRRRRRRTTTTTTTTTTTTTTTTTTTTTSSSSSSSSSSSSSSSSSSSSSSSSTTT
TRRRRRRRRRRRRRRRRRRRRRRRRRRRRRRRTTTTTTTTTTTTTTTTTTTTTSSSSSSSSSSSSSSSSSSSSSSSSTTT
TRRRRRRRRRRRRRRRRRRRRRRRRRRRRRRRPPPPPPPPPPPPPPPPPPPPPTTTTTTTTTTTTTTTTTTTTTTTTTTT
TRRRRRRRRRRRRRRRRRRRRRRRRRRRRRRRPPPPPPPPPPPPPPPPPPPPPTTTTTTTTTTTTTTTTTTTTTTTTTTT
TRRRRRRRRRRRRRRRRRRRRRRRRRRRRRRRPPPPPPPPPPPPPPPPPPPPPBBBBBBBBBBBBBBBBBBBBBBBBBBB
TRRRRRRRRRRRRRRRRRRRRRRRRRRRRRRRPPPPPPPPPPPPPPPPPPPPPBBBBBBBBBBBBBBBBBBBBBBBBBBB
TRRRRRRRRRRRRRRRRRRRRRRRRRRRRRRRPPPPPPPPPPPPPPPPPPPPPBBBBBBBBBBBBBBBBBBBBBBBBBBB
TRRRRRRRRRRRRRRRRRRRRRRRRRRRRRRRPPPPPPPPPPPPPPPPPPPPPBBBBBBBBBBBBBBBBBBBBBBBBBBB
TRRRRRRRRRRRRRRRRRRRRRRRRRRRRRRRPPPPPPPPPPPPPPPPPPPPPBBBBBBBBBBBBBBBBBBBBBBBBBBB
TRRRRRRRRRRRRRRRRRRRRRRRRRRRRRRRPPPPPPPPPPPPPPPPPPPPPBBBBBBBBBBBBBBBBBBBBBBBBBBB
TRRRRRRRRRRRRRRRRRRRRRRRRRRRRRRRPPPPPPPPPPPPPPPPPPPPPBBBBBBBBBBBBBBBBBBBBBBBBBBB